roomID,heavy,priority,demand1,demand2
1,2,0,0,2
2,1,0,0,1
3,1,0,0,1
4,1,0,0,1
5,1,0,0,1
6,1,0,0,1
7,1,0,0,2
8,1,0,0,2
9,1,0,0,2
10,1,0,0,1
