roomID,heavy,priority,demand1,demand2
1,2,0,1,1
2,1,0,1,0
3,1,0,1,0
4,1,0,1,0
5,1,0,0,1
6,1,0,1,0
7,1,0,1,1
8,1,0,1,1
9,1,0,1,1
10,1,0,0,1
