roomID,priority,heavy,demand1,demand2
1,3,4,2,5
2,4,5,2,4
3,1,3,5,5
4,2,4,0,5
5,0,0,3,5
6,0,3,2,5
7,2,0,0,5
8,3,3,1,0
9,1,0,5,4
10,0,1,4,4